S,0,1,0,1
-,-,2,1,2
2,-,3,0,-
0,2,1,1,-
1,0,G,1,-